1111111111111111111111111111111111
1000000001000001000000001000011001
1E000000000000000000000000C0000001
10100000000001010010C0000010101001
1010000000000100000010001000000001
1000000P0000000C000000000000000001
100000000C000000000000000000000001
1111111111111111111111111111111111