1111111111111111111111111111111111
1110000000000000000000000000000111
1010010100100000101001000010010101
1010010010101010001001000100011111
100000000000000000000C000010P00001
1111100000000000000000000000011111
1111111111111111111110111111111111
1000000000000000000000000000000001
1010010100100000101001000000010101
1010010010101010001001000000011111
100000000000000000000E000000000001
1111111111111111111111111111111111