1111111111111111111111111111111111
1110000000000000000000000000000111
1010010100100000101001000010010101
10100100101010100010010001P0011111
1000000000000000000000000010000001
111110000000000000000000C000011111
1111111111111111111011111111111111
1000000000000000000000000000000001
1010010100100000101001000000010101
1010010010101010001001000000011111
1000000000000000E00000000000000001
1111111111111111111111111111111111