1111111111111111111111111111111111111111111111111111
1000000001000000000000000000000000000000000000000001
1E000000010000000000000000C0000000000000000000000011
10100000010000000010C0000000101000000000000001100001
1010000011110000000000001000000000000000000000000011
1000000P0000000C000000000000000000000000000011011111
100000000C000000000000000000000000000000000000000001
10000000000000000000000000000C0000000000000000000001
1111111111000000000111111111111100000000001011110001
1000000000000000000000000001111100000000001110000001
1000000001000001000000001000011000000000000000000001
10000001000000011111100000C0000000000000000000000001
10000000000000010010C0000010101000000000000011110111
1000000000010000000010001000000000000000001111111111
100000000000000C000000000001111000000000011000000001
100011110C00000000000000000100000000000000000C000001
10000000000000000000000000000C0000000000001000000001
1111111111111111111111111111111111111111111111111111