1111111111111111111111111111111111
100000000000000C00000C000000000001
1010010100100000101001000000010101
1010010010101010001001000000011111
100000000C00C0000000000000000000C1
1111100000000000000000000000011111
1111111111111000000011111111111111
100000000000000C0E000C000000000001
1010010100100000101001000000010101
1010010010101010001001000P00011111
100000000C00C0000000000000000000C1
1111111111111111111111111111111111