1111111111111111111111111111111111
1E00000000000000000000000000000001
10101001000001010010C0000010101001
1010010010101010010010001000000001
1000000P00000000000000000000000001
1111111111111111111111111111111111